¡ö¡ö¡ö¡ö¡ö¡ö¡ö¡ö¡ö¡ö¡ö¡ö¡ö¡ö¡ö¡ö¡ö¡ö¡ö¡ö¡ö¡ö¡ö¡ö¡ö¡ö¡ö¡ö¡ö
¡ö¡¤¡¤¡¤¡¤¡¤¡¤¡¤¡¤¡¤¡¤¡¤¡¤¡¤¡¤¡¤¡¤¡¤¡¤¡¤¡¤¡¤¡¤¡¤¡¤¡¤¡¤¡¤¡ö
¡ö¡¤¡ö¡ö¡ö¡ö¡¤¡ö¡ö¡ö¡ö¡ö¡¤¡ö¡ö¡ö¡¤¡ö¡ö¡ö¡ö¡ö¡¤¡ö¡ö¡ö¡ö¡¤¡ö
¡ö¨’¡ö¡ö¡ö¡ö¡¤¡ö¡ö¡ö¡ö¡ö¡¤¡ö¡ö¡ö¡¤¡ö¡ö¡ö¡ö¡ö¡¤¡ö¡ö¡ö¡ö¨’¡ö
¡ö¡¤¡¤¡¤¡¤¡¤¡¤¡¤¡¤¡¤¡¤¡¤¡¤¡¤¡¤¡¤¡¤¡¤¡¤¡¤¡¤¡¤¡¤¡¤¡¤¡¤¡¤¡¤¡ö
¡ö¡¤¡ö¡ö¡ö¡ö¡¤¡ö¡ö¡¤¡ö¡ö¡ö¡ö¡ö¡ö¡ö¡ö¡ö¡¤¡ö¡ö¡¤¡ö¡ö¡ö¡ö¡¤¡ö
¡ö¡¤¡ö¡ö¡ö¡ö¡¤¡ö¡ö¡¤¡ö¡ö¡ö¡ö¡ö¡ö¡ö¡ö¡ö¡¤¡ö¡ö¡¤¡ö¡ö¡ö¡ö¡¤¡ö
¡ö¡¤¡¤¡¤¡¤¡¤¡¤¡ö¡ö¡¤¡¤¡¤¡¤¡ö¡ö¡ö¡¤¡¤¡¤¡¤¡ö¡ö¡¤¡¤¡¤¡¤¡¤¡¤¡ö
¡ö¡ö¡¤¡ö¡ö¡ö¡¤¡ö¡ö¡ö¡ö¡ö¡¤¡ö¡ö¡ö¡¤¡ö¡ö¡ö¡ö¡ö¡¤¡ö¡ö¡ö¡¤¡ö¡ö
¡ö¡ö¡¤¡ö¡ö¡ö¡¤¡ö¡ö¡¤¡¤¡¤¡¤¡¤¡¤¡¤¡¤¡¤¡¤¡¤¡ö¡ö¡¤¡ö¡ö¡ö¡¤¡ö¡ö
¡ö¡ö¡¤¡¤¡¤¡¤¡¤¡ö¡ö¡¤¡ö¡ö¡ö      ¡ö¡ö¡ö¡¤¡ö¡ö¡¤¡¤¡¤¡¤¡¤¡ö¡ö
¡ö¡ö¡¤¡ö¡ö¡ö¡¤¡ö¡ö¡¤¡ö¡ñ          ¡ñ¡ö¡¤¡ö¡ö¡¤¡ö¡ö¡ö¡¤¡ö¡ö
¡ö¡¤¡¤¡¤¡¤¡¤¡¤¡¤¡¤¡¤¡ö              ¡ö¡¤¡¤¡¤¡¤¡¤¡¤¡¤¡¤¡¤¡ö
¡ö¡ö¡ö¡ö¡ö¡ö¡¤¡ö¡ö¡¤¡ö  ¡ñ      ¡ñ  ¡ö¡¤¡ö¡ö¡¤¡ö¡ö¡ö¡ö¡ö¡ö
¡ö¡ö¡ö¡ö¡ö¡ö¡¤¡ö¡ö¡¤¡ö¡ö¡ö¡ö¡ö¡ö¡ö¡ö¡ö¡¤¡ö¡ö¡¤¡ö¡ö¡ö¡ö¡ö¡ö
¡ö¡ö¡ö¡ö¡ö¡ö¡¤¡ö¡ö¡¤¡¤¡¤¡¤¡¤¡ü¡¤¡¤¡¤¡¤¡¤¡ö¡ö¡¤¡ö¡ö¡ö¡ö¡ö¡ö
¡ö¡ö¡ö¡ö¡ö¡ö¡¤¡ö¡ö¡¤¡ö¡ö¡ö¡ö¡ö¡ö¡ö¡ö¡ö¡¤¡ö¡ö¡¤¡ö¡ö¡ö¡ö¡ö¡ö
¡ö¡¤¡¤¡¤¡¤¡¤¡¤¡¤¡¤¡¤¡¤¡¤¡¤¡ö¡ö¡ö¡¤¡¤¡¤¡¤¡¤¡¤¡¤¡¤¡¤¡¤¡¤¡¤¡ö
¡ö¡¤¡ö¡ö¡ö¡ö¡¤¡ö¡ö¡ö¡ö¡ö¡¤¡ö¡ö¡ö¡¤¡ö¡ö¡ö¡ö¡ö¡¤¡ö¡ö¡ö¡ö¡¤¡ö
¡ö¡¤¡ö¡ö¡ö¡ö¡¤¡ö¡ö¡ö¡ö¡ö¡¤¡ö¡ö¡ö¡¤¡ö¡ö¡ö¡ö¡ö¡¤¡ö¡ö¡ö¡ö¡¤¡ö
¡ö¨’¡¤¡¤¡ö¡ö¡¤¡¤¡¤¡¤¡¤¡¤¡¤¡¤¡¤¡¤¡¤¡¤¡¤¡¤¡¤¡¤¡¤¡ö¡ö¡¤¡¤¨’¡ö
¡ö¡ö¡ö¡¤¡ö¡ö¡¤¡ö¡ö¡¤¡ö¡ö¡ö¡ö¡ö¡ö¡ö¡ö¡ö¡¤¡ö¡ö¡¤¡ö¡ö¡¤¡ö¡ö¡ö
¡ö¡ö¡ö¡¤¡ö¡ö¡¤¡ö¡ö¡¤¡ö¡ö¡ö¡ö¡ö¡ö¡ö¡ö¡ö¡¤¡ö¡ö¡¤¡ö¡ö¡¤¡ö¡ö¡ö
¡ö¡¤¡¤¡¤¡¤¡¤¡¤¡ö¡ö¡¤¡¤¡¤¡¤¡¤¡¤¡¤¡¤¡¤¡¤¡¤¡ö¡ö¡¤¡¤¡¤¡¤¡¤¡¤¡ö
¡ö¡¤¡¤¡¤¡¤¡¤¡¤¡¤¡¤¡¤¡¤¡¤¡¤¡¤¡¤¡¤¡¤¡¤¡¤¡¤¡¤¡¤¡¤¡¤¡¤¡¤¡¤¡¤¡ö
¡ö¡¤¡ö¡ö¡ö¡ö¡ö¡ö¡ö¡ö¡ö¡ö¡¤¡ö¡ö¡ö¡¤¡ö¡ö¡ö¡ö¡ö¡ö¡ö¡ö¡ö¡ö¡¤¡ö
¡ö¡¤¡ö¡ö¡ö¡ö¡ö¡ö¡ö¡ö¡ö¡ö¡¤¡ö¡ö¡ö¡¤¡ö¡ö¡ö¡ö¡ö¡ö¡ö¡ö¡ö¡ö¡¤¡ö
¡ö¡¤¡¤¡¤¡¤¡¤¡¤¡¤¡¤¡¤¡¤¡¤¡¤¡¤¡¤¡¤¡¤¡¤¡¤¡¤¡¤¡¤¡¤¡¤¡¤¡¤¡¤¡¤¡ö
¡ö¡ö¡ö¡ö¡ö¡ö¡ö¡ö¡ö¡ö¡ö¡ö¡ö¡ö¡ö¡ö¡ö¡ö¡ö¡ö¡ö¡ö¡ö¡ö¡ö¡ö¡ö¡ö¡ö